+---------------------+          
|                     |          
|                     |          
|                     |          
|                     +---------+
|                               |
|                               |
|                               |
|                               |
+-------------------------------+