+=====================+          
|                .... |          
| BB             :;;: |          
| BB             :;;: |          
|                .... +=========+
|                               |
|                               |
|                             //|
|                               |
+===============================+